	LON	LAT	Globigerinella_siphonifera	Globigerinoides_sacculifer	Globigerinoides_ruber	Globigerina_bulloides	Turborotalita_quinqueloba	Globigerinella_calida	Orbulina_universa	Pulleniatina_obliquiloculata	Neogloboquadrina_pachyderma	Globorotalia_inflata	Neogloboquadrina_incompta	Globigerinita_uvula	Globorotalia_truncatulinoides	Globorotalia_scitula	Globorotalia_hirsuta
1	140	34	0	0	0	0	0	0	0	1	0	1	0	0	1	0	0
2	41	-9	1	0	0	0	0	1	1	0	0	0	0	0	0	0	0
3	100	-7	0	0	0	0	0	0	0	1	0	0	0	0	0	0	0
4	3	38	1	0	1	0	0	0	0	0	0	1	0	0	1	0	0
5	162	-14	0	1	0	0	0	0	1	1	0	0	0	0	0	0	0
6	-5	35	1	1	1	0	0	0	0	0	0	0	0	0	0	1	0
7	129	32	0	0	0	0	0	0	0	1	0	0	0	0	0	0	0
8	-69	33	0	0	0	0	0	0	0	1	0	1	0	0	0	0	0
9	40	-9	1	1	0	0	0	1	0	0	0	0	0	0	0	0	0
10	-165	2	0	0	0	0	0	0	0	1	0	0	0	0	0	0	0
11	-22	39	0	0	0	0	0	0	0	0	0	1	0	0	1	0	0
12	2	38	0	1	1	0	0	0	0	0	0	0	1	0	1	0	0
13	-159	8	0	0	1	0	0	0	0	0	0	0	0	0	0	0	0
14	-20	35	0	1	1	0	0	0	0	0	0	1	1	0	1	0	0
15	-128	49	0	0	0	0	1	0	0	0	1	0	0	0	0	0	0
16	2	39	0	1	1	0	0	0	0	0	0	0	0	0	0	0	0
17	-62	-59	0	0	0	1	0	0	0	0	0	0	0	0	0	0	0
18	-12	30	0	0	1	0	0	0	0	0	0	0	0	0	0	1	0
19	-137	-33	0	0	0	0	0	0	0	0	0	0	0	1	0	1	1
20	171	-26	1	0	0	0	0	0	0	0	0	0	0	0	0	0	0
21	-152	-36	0	0	0	0	0	0	0	0	0	0	0	0	0	1	1
22	10	74	0	0	0	0	0	0	0	0	1	0	0	0	0	0	0
23	161	-4	0	1	0	0	0	0	0	1	0	0	0	0	0	0	0
24	167	-10	1	0	0	0	0	1	0	0	0	0	0	0	0	0	0
25	-61	-55	0	0	0	0	1	0	0	0	1	0	0	0	0	0	0
26	67	-17	0	1	0	0	0	0	0	1	0	0	0	0	0	0	0
27	-3	36	0	0	1	0	0	0	0	0	0	0	0	0	1	1	0
28	-56	-46	0	0	0	0	0	0	0	0	0	1	0	0	0	0	0
29	-20	33	0	0	1	0	0	0	0	0	0	0	0	0	0	0	0
30	39	-8	1	0	0	0	0	1	1	0	0	0	0	0	0	1	0
31	162	0	0	0	0	0	0	0	0	1	0	0	0	0	0	0	0
32	0	35	0	0	1	0	0	0	0	0	0	0	0	0	0	0	0
33	-59	-64	0	0	0	0	1	0	0	0	1	0	0	0	0	0	0
34	-130	-32	0	1	0	0	0	0	0	0	0	0	0	0	0	0	1
35	-56	-52	0	0	0	0	1	0	0	0	1	0	1	0	0	0	0
36	52	-40	0	0	0	0	0	0	0	0	0	1	0	0	0	0	0
37	145	-14	1	1	0	1	1	0	1	1	0	0	0	0	0	0	0
38	-19	29	0	0	1	0	0	0	0	0	0	0	0	0	0	0	0
39	64	-48	0	0	0	1	0	0	0	0	0	1	0	0	0	0	0
40	-60	-54	0	0	0	0	1	0	0	0	1	0	0	0	0	0	0
41	-28	34	0	0	0	0	0	0	0	0	0	0	0	0	1	1	1
42	37	-18	1	1	0	0	0	1	1	0	0	0	0	0	0	0	1
43	-159	3	0	0	1	0	0	0	0	0	0	0	0	0	0	0	0
44	-164	-5	0	0	0	0	0	0	0	1	0	0	0	0	0	0	0
45	63	15	1	0	0	1	1	0	0	0	0	0	0	0	0	0	0
46	-65	-61	0	0	0	0	1	0	0	0	1	0	0	0	0	0	0
47	-140	-34	0	0	0	0	0	0	0	0	0	0	0	1	0	0	0
48	-6	35	0	0	1	0	0	0	0	0	0	0	0	0	0	0	0
49	-14	47	1	0	0	0	0	1	0	0	0	0	0	0	0	0	0
50	52	-45	0	0	0	1	0	0	0	0	0	1	0	0	0	0	0
51	-50	58	0	0	0	0	0	0	0	0	0	0	0	1	0	0	0
52	-20	38	0	0	0	0	0	0	0	0	0	0	1	0	0	0	0
53	157	25	0	0	0	0	0	0	0	0	0	0	0	0	1	0	0
54	145	30	0	0	0	0	0	0	0	0	0	0	0	0	1	0	0
55	-21	33	0	0	0	0	0	0	0	0	0	1	0	0	1	0	0
56	40	16	1	1	0	0	0	0	1	0	0	0	0	0	0	0	0
57	-22	33	0	0	1	0	0	0	0	0	0	0	0	0	0	0	1
58	41	-14	1	0	0	0	0	1	1	0	0	0	0	0	0	0	0
59	162	-20	0	0	0	0	0	0	1	0	0	0	0	0	0	0	0
60	-60	-55	0	0	0	0	1	0	0	0	1	0	0	0	0	0	0
61	14	-23	0	0	0	0	0	0	0	0	0	0	1	0	0	0	0
62	-143	-34	0	0	0	0	0	0	0	0	0	1	0	0	0	0	1
63	39	-7	1	0	0	0	0	0	1	1	0	0	0	0	0	0	0
64	145	39	0	1	0	0	0	1	0	0	0	1	0	0	0	0	0
65	162	-9	0	1	0	0	0	0	0	0	0	0	0	0	0	0	0
66	139	35	1	0	0	0	0	0	0	0	0	0	0	0	0	0	0
67	59	22	0	0	0	1	1	0	0	0	0	0	0	0	0	0	0
68	-7	45	0	0	0	1	0	0	0	0	0	1	0	0	0	0	0
69	-141	52	0	0	0	0	0	0	0	0	1	0	1	0	0	0	0
70	-146	-35	0	0	0	0	0	0	0	0	0	1	0	0	0	1	1
71	73	-15	0	1	0	0	0	0	0	1	0	0	0	0	0	0	0
72	-158	14	0	0	1	0	0	0	0	0	0	0	0	0	0	0	0
73	-9	33	0	0	1	0	0	0	0	0	0	0	0	0	0	0	0
74	-15	29	1	0	0	0	0	0	0	0	0	0	0	0	0	0	0
75	-21	35	1	0	0	0	0	0	0	0	0	1	0	1	0	0	0
76	-50	53	0	0	0	0	0	0	0	0	0	0	0	1	0	0	0
77	4	37	1	1	0	0	0	0	0	0	0	0	0	0	0	0	0
78	-169	0	0	0	1	0	0	0	0	0	0	0	0	0	0	0	0
79	-20	34	0	0	1	0	0	0	0	0	0	0	0	0	0	0	0
80	-8	36	0	0	1	0	0	0	0	0	0	0	1	0	0	0	0
81	170	-22	1	0	0	0	0	0	0	0	0	0	0	0	0	0	0
82	-31	32	1	0	0	0	0	0	0	0	0	0	0	0	0	0	0
83	-15	47	1	0	0	0	0	1	0	0	0	0	0	0	0	0	0
84	63	-56	0	0	0	1	0	0	0	0	0	0	0	0	0	0	0
85	-49	59	0	0	0	0	0	0	0	0	0	0	0	1	0	0	0
86	61	16	0	0	0	0	1	0	0	0	0	0	1	0	0	0	0
87	-52	62	0	0	0	0	0	0	0	0	0	0	0	1	0	0	0
88	133	33	0	0	0	0	0	0	0	1	0	1	0	0	0	0	0
89	162	-6	0	1	0	0	0	0	0	1	0	0	0	0	0	0	0
90	41	15	1	0	0	0	0	0	0	0	0	0	0	0	0	0	0
91	-118	33	1	0	0	1	0	0	1	0	0	0	0	0	0	0	0
92	-120	34	1	0	0	0	1	0	0	0	0	0	1	0	0	0	0
93	-19	45	1	0	0	0	0	1	0	0	0	0	0	0	0	0	0
94	63	6	1	0	0	0	0	0	0	0	0	0	0	0	0	0	0
95	15	35	0	0	0	1	0	0	0	0	0	0	0	0	0	0	0
96	-6	45	0	0	0	1	0	0	0	0	0	0	0	0	0	0	0
97	72	-47	0	0	0	1	0	0	0	0	0	0	0	0	0	0	0
98	66	-29	0	0	0	0	0	0	0	0	0	0	0	1	0	0	0
99	-51	-52	0	0	0	0	0	0	0	0	0	0	1	0	0	0	0
100	-19	32	0	0	0	0	0	0	0	0	0	0	0	0	0	1	0
101	162	-3	0	0	0	0	0	0	0	1	0	0	0	0	0	0	0
102	-69	11	1	1	0	0	0	0	1	0	0	0	0	0	0	0	0
103	-21	30	0	1	1	0	0	0	0	0	0	0	0	0	0	0	0
104	-8	33	0	0	1	0	0	0	0	0	0	0	0	0	0	0	0
105	26	34	0	0	1	0	0	0	0	0	0	0	0	0	0	0	0
106	40	-16	1	0	0	0	0	0	0	0	0	0	0	0	0	0	0
107	-119	34	1	0	0	0	1	0	0	0	0	0	0	0	0	0	0
108	-19	46	1	0	0	0	0	0	0	0	0	0	0	0	0	0	0
109	-18	46	1	0	0	0	0	1	0	0	0	0	0	0	0	0	0
110	-17	62	0	0	0	0	0	0	1	0	0	0	0	0	0	0	0
111	58	-47	0	0	0	1	0	0	0	0	0	0	0	0	0	0	0
112	68	-50	0	0	0	1	0	0	0	0	0	0	0	0	0	0	0
113	-173	58	0	0	0	0	1	0	0	0	0	0	0	0	0	0	0
114	52	-42	0	0	0	0	0	0	0	0	0	0	1	1	0	0	0
115	-48	54	0	0	0	0	0	0	0	0	0	0	0	1	0	0	0
116	13	-23	0	0	0	0	0	0	0	0	1	0	1	0	0	0	0
117	-113	-27	0	0	0	0	0	0	0	0	0	0	0	0	0	0	1
118	-118	-29	0	0	0	0	0	0	0	0	0	0	0	0	0	0	1
119	-21	29	0	0	0	0	0	0	0	0	0	0	0	0	1	0	0
120	-176	-42	0	0	0	0	0	0	0	0	0	0	0	0	0	1	0
121	161	-16	0	0	0	0	0	0	1	1	0	0	0	0	0	0	0
122	-60	10	0	1	0	0	0	0	0	0	0	0	0	0	0	0	0
123	-64	12	0	1	0	0	0	1	0	0	0	0	0	0	0	0	0
124	80	-14	0	1	0	0	0	0	0	0	0	0	0	0	0	0	0
125	63	9	1	0	0	0	0	0	0	0	0	0	0	0	0	0	0
126	65	15	1	0	0	0	0	0	0	0	0	0	0	1	0	0	0
127	34	29	1	0	0	0	0	0	0	0	0	0	0	0	0	0	0
128	135	31	1	0	0	0	0	0	0	0	0	0	0	0	0	0	0
129	-29	32	1	0	0	0	0	0	0	0	0	0	0	0	0	0	0
130	53	-35	1	0	0	0	0	0	0	0	0	0	0	0	0	0	0
131	-26	37	1	0	0	0	0	1	0	0	0	0	0	0	0	0	0
132	-24	39	1	0	0	0	0	0	0	0	0	0	0	0	0	0	0
133	-22	34	0	0	0	0	0	1	0	0	0	0	0	0	0	0	0
134	-54	19	0	0	0	0	0	0	1	0	0	0	0	0	0	0	0
135	-32	59	0	0	0	0	0	0	1	0	0	0	0	1	0	0	0
136	74	-42	0	0	0	1	0	0	0	0	0	0	0	0	0	0	0
137	-5	46	0	0	0	1	0	0	0	0	0	0	0	0	0	0	0
138	-54	-53	0	0	0	0	1	0	0	0	1	0	1	0	0	0	0
139	-168	54	0	0	0	0	1	0	0	0	0	0	0	0	0	0	0
140	162	0	0	1	0	0	0	0	0	0	0	0	0	0	0	0	0
141	-9	32	0	0	1	0	0	0	0	0	0	0	0	0	0	0	0
142	26	33	0	0	1	0	0	0	0	0	0	0	0	0	0	0	0
143	25	34	0	0	1	0	0	0	0	0	0	0	0	0	0	0	0
144	17	39	1	0	1	0	0	0	0	0	0	0	0	0	0	0	0
145	42	-10	1	0	0	0	0	0	0	0	0	0	0	0	0	0	0
146	43	13	1	0	0	0	0	0	0	0	0	0	0	0	0	0	0
147	-18	30	1	0	0	0	0	1	0	0	0	0	0	0	0	0	0
148	-26	33	1	0	0	0	0	0	0	0	0	0	0	0	0	0	0
149	39	-5	1	0	0	0	0	0	0	0	0	0	0	0	0	0	0
150	40	-8	1	0	0	0	0	0	0	0	0	0	0	0	0	0	0
151	-12	57	0	0	0	0	0	0	1	0	0	0	0	0	0	0	0
152	-16	62	0	0	0	0	0	0	1	0	0	0	0	0	0	0	0
153	-9	42	0	0	0	1	0	0	0	0	0	0	0	0	0	0	0
154	65	19	0	0	0	0	1	0	0	0	0	0	0	0	0	0	0
155	-57	-51	0	0	0	0	1	0	0	0	0	0	0	0	0	0	0
156	-48	57	0	0	0	0	0	0	0	0	0	0	0	1	0	0	0
157	-22	26	0	0	0	0	0	0	0	0	0	0	0	0	0	1	0
158	-127	49	0	0	0	0	0	0	0	0	1	0	0	0	0	0	0
159	-64	-57	0	0	0	0	0	0	0	0	1	0	0	0	0	0	0
160	-22	37	0	0	0	0	0	0	0	0	0	0	0	0	1	0	0
161	-166	7	0	0	0	0	0	0	0	1	0	0	0	0	0	0	0
162	-68	15	0	1	0	0	0	0	0	0	0	0	0	0	0	0	0
163	64	20	0	1	0	0	0	0	0	0	0	0	0	0	0	0	0
164	162	-23	0	1	0	0	0	0	0	0	0	0	0	0	0	0	0
165	-22	31	0	1	0	0	0	0	0	0	0	0	0	0	0	0	0
166	160	-7	0	1	0	0	0	0	0	0	0	0	0	0	0	0	0
167	28	33	0	0	1	0	0	0	0	0	0	0	0	0	0	0	0
168	0	37	0	0	1	0	0	0	0	0	0	0	0	0	0	0	0
169	41	-10	1	0	0	0	0	0	0	0	0	0	0	0	0	0	0
170	-77	14	1	0	0	0	0	0	0	0	0	0	0	0	0	0	0
171	64	18	1	0	0	0	0	0	0	0	0	0	0	0	0	0	0
172	113	18	1	0	0	0	0	0	0	0	0	0	0	0	0	0	0
173	35	-25	1	0	0	0	0	0	0	0	0	0	0	0	0	0	0
174	63	3	1	0	0	0	0	0	0	0	0	0	0	0	0	0	0
175	133	32	1	0	0	0	0	0	0	0	0	0	0	0	0	0	0
176	134	32	1	0	0	0	0	0	0	0	0	0	0	0	0	0	0
177	-28	33	1	0	0	0	0	0	0	0	0	0	0	0	0	0	0
178	-31	34	1	0	0	0	0	0	0	0	0	0	0	0	0	0	0
179	-29	35	1	0	0	0	0	0	0	0	0	0	0	0	0	0	0
180	-21	43	1	0	0	0	0	0	0	0	0	0	0	0	0	0	0
181	9	43	1	0	0	0	0	0	0	0	0	0	0	0	0	0	0
182	53	-10	0	0	0	0	0	1	0	0	0	0	0	0	0	0	0
183	-72	15	0	0	0	0	0	1	0	0	0	0	0	0	0	0	0
184	-83	18	0	0	0	0	0	1	0	0	0	0	0	0	0	0	0
185	-80	24	0	0	0	0	0	1	0	0	0	0	0	0	0	0	0
186	-21	32	0	0	0	0	0	1	0	0	0	0	0	0	0	0	0
187	-54	14	0	0	0	0	0	0	1	0	0	0	0	0	0	0	0
188	41	-8	0	0	0	0	0	0	1	0	0	0	0	0	0	0	0
189	131	31	0	0	0	1	0	0	0	0	0	0	0	0	0	0	0
190	76	-40	0	0	0	1	0	0	0	0	0	0	0	0	0	0	0
191	-10	42	0	0	0	1	0	0	0	0	0	0	0	0	0	0	0
192	144	42	0	0	0	1	0	0	0	0	0	0	0	0	0	0	0
193	-8	44	0	0	0	1	0	0	0	0	0	0	0	0	0	0	0
194	73	-44	0	0	0	1	0	0	0	0	0	0	0	0	0	0	0
195	-5	45	0	0	0	1	0	0	0	0	0	0	0	0	0	0	0
196	-58	-52	0	0	0	0	1	0	0	0	0	0	0	0	0	0	0
197	-45	-52	0	0	0	0	1	0	0	0	0	0	0	0	0	0	0
198	-173	56	0	0	0	0	1	0	0	0	0	0	0	0	0	0	0
199	-49	51	0	0	0	0	0	0	0	0	0	0	0	1	0	0	0
200	-14	61	0	0	0	0	0	0	0	0	0	0	0	1	0	0	0
201	-52	-53	0	0	0	0	0	0	0	0	0	0	1	0	0	0	0
202	-58	-53	0	0	0	0	0	0	0	0	0	0	1	0	0	0	0
203	-45	-55	0	0	0	0	0	0	0	0	0	0	1	0	0	0	0
204	-44	-52	0	0	0	0	0	0	0	0	1	0	0	0	0	0	0
205	-44	-56	0	0	0	0	0	0	0	0	1	0	0	0	0	0	0
206	-64	-58	0	0	0	0	0	0	0	0	1	0	0	0	0	0	0
207	-63	-63	0	0	0	0	0	0	0	0	1	0	0	0	0	0	0
208	-51	-38	0	0	0	0	0	0	0	0	0	1	0	0	0	0	0